6 13 31
###############################
#p *3*       *  ** * *      * #
# # # # #*# # #*# # # # # #*# #
#    * * **     sf   *    **  #
# #*# # # # # # #b# # # # # #*#
#          *             *  **#
# # #*# # # # #*#*#*#*#*# # # #
#   *        s   *   * *      #
# # # # #*# # #*#*#*#*#*# #*# #
#   ****         *            #
# # # # # # # # # #*# # # # #*#
#  ** *  *                    #
###############################