7 13 31
###############################
#p    * **    *               #
# # # #*# # # # # # # # # # # #
#   x  ** * *  *   * **   *   #
# # # # # #*# # # # # # #*# # #
#*   * *    *b* *   **        #
# # # # #*#*# # # # # # # #*# #
#    *     *        *    **   #
# #*# # #*#*#*#*# # # # # #*# #
#        *   * *    *   *     #
#*# # # # # # # # # # #*# # #*#
#x*    * **    ** ***         #
###############################