6 13 31
###############################
#p * *       *  ** * *      * #
# # # # #*# # #*# # # # # #*# #
#    * * **     sf   *    **  #
# #*# # # # # # #b# # # # # #*#
#          *             *  **#
# # #*# # # # #*#*#*#*#*# # # #
#   *  3     s   *   * *      #
# # # # #*# # #*#*#*#*#*# #*# #
#   ****         *            #
# # # # # # # # # #*# # # # #*#
#  ** *  *                    #
###############################